###############
# ##  #########
#    #        #
######        #
#    ##########
#             #
#             #
#             #
#             #
######        #
#             #
#             #
#    #        #
#    #       ##
###############

