###############
# ##  #########
#    #        #
######        #
#    ##########
#             #
#             #
#             #
#             #
######        #
#             #
#             #
# #  #        #
# m  #       ##
###############

