###############
# ##     ######
#    ##       #
####          #
#           ###
#             #
#####         #
#             #
#       #######
######        #
#             #
#          #####
# #  #        #
# m  #       ##
###############

