###############
#g##     ######
#    ##       #
####          #
#           ###
#             #
#####         #
#             #
#       #######
######        #
#             #
#          ####
# #  #        #
# m  #       ##
###############

